1111111111111111111111111111111111
1000010000000000000000000000000001
10P00100000000000000000000C0000001
1101110000000000000000000000000001
10000C0000000000000000000000000001
1000000000000000000000000000000001
1000000011110000000100000000000001
1000000100010000000100000000000001
100000000C010000000100000000000001
1000000100010000000100000000000001
1000000011110000000111110000000001
1000000000000000000000000000000001
1000000000000000000C00000000000001
1000000000000000000000000000000001
1111111111111111001111111111111111
1000000000000001001000000010000001
1000000000000001001000000010000001
1000000C000000010010000E0010000001
1000000000000000000000000000000001
1111111111111111111111111111111111
