111111111
10E000001
100000001
100000P01
111111111
