111111111101111111111111
100E100000001C000000P001
100000000000000000000001
111111111111111111111111
