11111111
1C0P00E11111
111110000001
    10000001
    11111111