1111111111111111111111111111111111
1E01C0001000000C00000C000000000001
1011101110100P001010010CCC00010101
1010010010101010001001000000010101
100000000C00C0000000000000000000C1
100000000C00C0000000000000000000C1
100000000C00C0000000000000000000C1
100000000C00C0000000000000000000C1
100000000C00C0000000000000000000C1
100000000C00C0000000000000000000C1
1111111111111111111111111111111111
