111111111
10000P001
1C1E01001
111111111
