1111111111
10E0000001
10000C00P1
1000000001
1000000001
1111111111
