1111111111111111111111111111111111
1000000000000000000000000000000001
10P00000000000000000000000C0000001
1000000000000000000000000000000001
10000C0000000000000000000000000001
1000000000000000000000000000000001
1000000000000000000100000000000001
1000000000000000000100000000000001
100000000C000000000100000000000001
1000000100010000000010000000000001
1000000011110000000111110000000001
1000000000000000000000000000000001
1000000000000000000C00000000000001
1000000000000000000000000000000001
1111111111111111001111111111111111
1000000000000001001000000010000001
1000000000000001001000000010000001
1000000C00000001001000000010000E01
1000000000000000000000000000000001
1111111111111111111111111111111111
