1111111111111111111
10E00000C0000001111
1111011111100001111
1000000000100P01111
100C000000100001111
1000111110110000001
1111111111111111111
