1111111
1E0C0E1
1000001
1C0P0C1
1000001
1E0C0E1
1111111
