111111111111111111
10000E00000000C001
10P001110011100C01
100000110011111111
110000011110000011
111000001100000111
111100000000001111
111110000000011111
10001100CC00110001
10001100CC00110001
111110000000011111
111100000000001111
111000001100000111
110000011110000011
100000110011000101
10C001110011100101
100011110011111101
111111111111111111
