11111111111111111
10000100001110001
1E10100100C100011
101000011000000P1
11111111111111111
