1111111111111111111111
1000000000011111111111
100C000000000C00011111
100000111111000000C001
1001111111111111000011
100PE11111111111111111
1111111111111111111111
