111111
10P0C1
100001
1E0001
111111
