111111
10P1C1
100101
10E001
111111
